..........
..........
..........
.***......
.*#*......
.*.#######
..****...#
......*..#
.......*0#
##########