######################################################
..#...........................#........#.......#......
#.#.#.########.#######.###.#####.#####....####.#.#####
#.#.#.#.#......#.......#.#.#...#.#...####.#..#.#.....#
#...#...#..###########.#.....#.#...#....####.#.###.#.#
#.#######..#.#...#...#########.#.######.#....#...#.###
#.#...#....#...#.#.#...#.....#.#.#...#..#.#.##.#.#...#
#.#.#.##########.#.#####.###.#.#.#.#.#.##.#.#..#.###.#
#.#.#.#...#....#.#.........#.#...#.#.#....#.#.####...#
#...#...#....#.#.#########.#.#####.########.#.#....#.#
#.#.##########...#.......#.#.....#...#......#.#..#####
#.#..........#.#######.#...#.#######.###########.#...#
#.#########..#.#.....#.#####.#...#.#.#...#...#.#.###.#
#.#...#...##########.#.....#...#.#.#...#.#.#...#...#.#
#...#.#.#..........#.#####.#.###.#.#.#.#.#.######.##.#
#####.#.#.########.#.#...#.#.#.#...#.###...#.#.#.....#
#.....#.#.#......#...#.#.#.#.#.#####...#.#...#...#.#.#
#.#####.#.######.#####.#.#.###.#...###.#.###########.#
#.......#..............#.........#.....#.............#
######################################################