######################################################
A@#...........................#........#.......#.....B
#.#.#.########.#######.###.#####.#####....#### #.#####
#.#.#.#.#......#.......#.#.#...#.#...####.#..#.#.....#
#...#...#..###########.#.....#.#...#....####.#.###.#.#
#.#######..#.#...#...#########.#.######.#....#...#.###
#.#...#....#...#.#.#...#.....#.#.#...#..#.#.##.#.#...#
#.#.#.##########.#.#####.###.#.#.#.#.#.##.#.#..#.###.#
#.#.#.#...#....#.#.........#.#...#.#.#....#.#.####...#
#...#...#....#.#.#########.#.#####.########.# #....#.#
#.#.##########...#.......#.#.....#...#......#.#..#####
#.#..........#.#######.#...#.#######.###########.#...#
#.#########..#.#.....#.#####.#...#.#.#...#...#.#.###.#
#.#...#...##########.#.....#...#.#.#...#.#.#...#...#.#
#...#.#.#..........#.#####.#.###.#.#.#.#.#.######.##.#
#####.#.#.########.#.#...#.#.#.#...#.###...#.#.#.....#
#.....#.#.#......#...#.#.#.#.#.#####...# #...#...# #.#
#.#####.#.######.#####.#.#.###.#...###.#.###########.#
#.......#..............#.........#.....#.............#
######################################################