..........
..........
..........
..........
..........
...#######
.........#
.........#
.........#
##########